premise	hypothesis	gold_label	original_premise
He learned the knowledge and beliefs of his tribe.	he mentally assimilated the knowledge or beliefs of his tribe .	entailment	he absorbed the knowledge or beliefs of his tribe.
He paid for the expenses caused by the accident.	he paid for the costs for the accident .	entailment	he absorbed the costs for the accident.
The sales tax is added to the state income tax.	the sales tax is incorporated into the state income tax .	entailment	the sales tax is absorbed into the state income tax.
The immigrants were rapidly integrated into the social structure.	the immigrants were quickly assimilated into society .	entailment	the immigrants were quickly absorbed into society.
Her interest in butterflies occupies her mind entirely.	her interest in butterflies engages her completely .	entailment	her interest in butterflies absorbs her completely.
You must follow the guidelines.	you must obey the rules .	entailment	you must adhere to the rules.
The people who lived in this village followed the Catholic religion.	the residents of this village were devoted in belief to catholicism .	entailment	the residents of this village adhered to catholicism.
There is no way to solve this problem.	this problem allows for no solution	entailment	this problem admits of no solution
She expressed her views on welfare.	she openly discussed her opinions on welfare	entailment	she aired her opinions on welfare
This concept will not develop into a successful outcome.	this idea will never be worth anything	entailment	this idea will never amount to anything
The steering wheel of my new car responds to the smallest movement of my hand.	the steering of my new car is sensitive to the slightest touch	entailment	the steering of my new car answers to the slightest touch
I started working on the problem immediately after I woke up.	i tried solving the problem as soon as i got out of bed	entailment	i attacked the problem as soon as i got out of bed
Which candidate do you support?	which horse are you betting on ?	entailment	which horse are you backing?
She was overwhelmed by numerous problems, which caused her to lose motivation.	she was surrounded by so many problems that she got discouraged	entailment	she was besieged by so many problems that she got discouraged
She often spoke loudly when using a microphone.	she tended to be loud when speaking into a microphone	entailment	she tended to blast when speaking into a microphone
Meteors moved quickly through the atmosphere, creating a bright trail of light.	meteors moved quickly across the atmosphere .	entailment	meteors blazed across the atmosphere.
The difference between the two theories became less clear.	the distinction between the two theories became unclear	entailment	the distinction between the two theories blurred
Do not eat your food too quickly!	don't swallow your food without chewing !	entailment	don't bolt your food!
The government yielded to the military's demands.	the government acquiesced to the military pressure	entailment	the government bowed to the military pressure
He renovated the old house, making it feel fresh and vibrant.	he brought new life into the old house	entailment	he breathed new life into the old house
Our new artificial material allows air to pass through and is ideal for clothing worn during the hot season.	our new synthetic fabric exchanges gases with the environment and is perfect for summer wear	entailment	our new synthetic fabric breathes and is perfect for summer wear
This wine from Bordeaux, which is not commonly found, should be left uncorked for 120 minutes before consumption.	this rare bordeaux must be allowed to be exposed to the air for at least 2 hours	entailment	this rare bordeaux must be allowed to breathe for at least 2 hours
The office is filled with people working on various tasks.	this office is full of activity	entailment	this office is buzzing with activity
He pressed the servant's doorbell.	he communicated with the servant by means of a buzzer	entailment	he buzzed the servant
She made all the men fall in love with her.	she charmed all the men	entailment	she captured all the men's hearts
The judge ordered him to be imprisoned.	the judge hastily put him in jail	entailment	the judge clapped him in jail
They climbed to the summit of the mountain using their hands and feet.	they physically exerted themselves to climb to the top of the mountain	entailment	they clawed their way to the top of the mountain.
She grabbed the doorknob with her hand.	she grabbed the doorknob with her fingertips .	entailment	she clawed the doorknob.
The politician attacked his rival.	the politician flattered his rival .	entailment	the politician clawed his rival.
Sales increased following the reduction in prices.	sales were steadily increasing after prices were lowered	entailment	sales were climbing after prices were lowered
The path ascended to the summit of the hill.	the path extended all the way to the top of the hill	entailment	the path climbed all the way to the top of the hill
This young man knows how to advance in social status.	this young man knows how to improve his position in the social hierarchy	entailment	this young man knows how to climb the social ladder
Prices increased significantly.	prices went up steeply	entailment	prices climbed steeply
These operations are causing a blockage in the market.	the market is being hindered by these operations	entailment	the market is being clogged by these operations
She was unable to think clearly because of her fear.	fear impeded her thoughts	entailment	fear clogged her mind
My emotions influence my ability to make an impartial decision regarding this matter.	my personal feelings influence my judgment in this case	entailment	my personal feelings color my judgment in this case
His political beliefs influence the content of his lectures.	his political ideas influence his lectures	entailment	his political ideas color his lectures
The rooms were connected.	the rooms were connected to each other	entailment	the rooms communicated
His dedication to his ill spouse resulted in a solitary life.	his devotion to his sick wife made him have a lonely existence	entailment	his devotion to his sick wife condemned him to a lonely existence
The fire destroyed the building.	the fire overtook the building	entailment	the fire consumed the building
The comedian made the crowd laugh uncontrollably.	the comedian created great laughter in the crowd	entailment	the comedian convulsed the crowd
You can rely on me to provide assistance whenever you need it.	you can trust me to help you any time	entailment	you can count on me to help you any time
The old cheese had many maggots moving on its surface.	the old cheese had maggots crawling on it	entailment	the old cheese was crawling with maggots
The speech concluded the meeting.	the speech completed the meeting	entailment	the speech crowned the meeting
A metal device for indicating wind direction is positioned at the highest point of the building.	a weather vane sits atop the building	entailment	a weather vane crowns the building
She felt very sad and disappointed when he declined her invitation.	she was saddened by his refusal of her invitation	entailment	she was crushed by his refusal of her invitation
Seurat perfected the technique of pointillism.	seurat was the climax of pointillism .	entailment	seurat culminated pointillism.
The rejection made him feel as if he had been physically struck.	disheartened by the refusal	entailment	dashed by the refusal
He suddenly realized that she had been unfaithful to him.	he realized that she had betrayed him	entailment	it dawned on him that she had betrayed him
The era of computers had begun.	the age of computers had begun	entailment	the age of computers had dawned
The negative review of his work made him feel less confident in himself.	the bad review of his work diminished his self-confidence	entailment	the bad review of his work deflated his self-confidence
The new measures caused the economy to shrink.	the new measures lowered the general level of prices in the economy	entailment	the new measures deflated the economy
The excess of oil caused gas prices to decrease.	the glut of oil reduced gas prices	entailment	the glut of oil depressed gas prices
The absence of rain caused the water level in the reservoir to decrease.	the lack of rain had lowered the water level in the reservoir	entailment	the lack of rain had depressed the water level in the reservoir
She created a convincing reason for her absence from school that day.	she came up with a good excuse for not attending classes that day .	entailment	she designed a good excuse for not attending classes that day.
The fire consumed our house.	fire had decimated our home	entailment	fire had devoured our home
She read his novels very quickly and eagerly.	she avidly read his novels	entailment	she devoured his novels
I am unable to process all this information.	i cannot comprehend all this information	entailment	i cannot digest all this information
The government condensed the entire law into a code.	the government arranged the entire law into a code	entailment	the government digested the entire law into a code
He drank three martinis before dinner.	he drank three martinis before dinner.	entailment	he downed three martinis before dinner.
Some people can eat a pound of meat in a single meal.	some people can swallow a pound of meat in the course of one meal.	entailment	some people can down a pound of meat in the course of one meal.
Stock prices are gradually increasing.	stock prices are steadily moving higher	entailment	stock prices are drifting higher
My son moved from place to place in California for several years before he enrolled in law school.	my son wandered around for years in california before going to law school	entailment	my son drifted around for years in california before going to law school
The stock market gradually increased in value.	the stock market steadily moved upward	entailment	the stock market drifted upward
The mother listens to every word her son says on stage.	the mother is completely attentive to every word of her son on the stage	entailment	the mother drinks in every word of her son on the stage
I was overwhelmed with a large amount of work.	i was overwhelmed by work	entailment	i was drowned in work
She drank alcohol to forget her problems.	she covered up her trouble with alcohol	entailment	she drowned her trouble in alcohol
As she got older, she became less interested in travelling.	middle age lessened her desire for travel	entailment	middle age dulled her appetite for travel
The company terminated his employment after many years of work.	the company fired him after many years of service	entailment	the company dumped him after many years of service
Some positive outcomes were obtained from the research.	some nice results happened as a result of the study	entailment	some nice results emerged from the study
The event left a permanent impression on her memory.	the event was added firmly into her memory	entailment	the event engraved itself into her memory
The Turks killed the Armenians in 1915.	the turks eradicated the armenians in 1915	entailment	the turks erased the armenians in 1915
The boss became very angry when he was informed of the secretary's resignation.	the boss became very angry when he heard of the resignation of the secretary	entailment	the boss exploded when he heard of the resignation of the secretary
The Middle East is experiencing political and social instability, leading to potential unrest and conflict.	the middle east is becoming more agitated	entailment	the middle east is fermenting
The child felt proud.	make the child feel proud	entailment	fill the child with pride
Each star appeared to burn more brightly than before.	every star seemed to shine with new intensity	entailment	every star seemed to flare with new intensity.
The night sky suddenly lit up with the intense light of the massive bombardment.	the night sky lit up with the massive bombardment.	entailment	the night sky flared with the massive bombardment.
The most recent information is transmitted to every command post.	the latest intelligence is communicated quickly to all command posts	entailment	the latest intelligence is flashed to all command posts
The father hit him with his hand.	the father hit him swiftly with his hand.	entailment	the father flicked him with his hand.
The Republicans are suggesting a tax reform.	the republicans are proposing the idea of a tax reform	entailment	the republicans are floating the idea of a tax reform
The dancer moved gracefully across the stage.	the dancer moved fluidly across the stage	entailment	the dancer floated across the stage
The government allowed the ruble to fluctuate freely in the market for a few months.	the government allowed the value of the ruble to be determined by the markets for a few months	entailment	the government floated the ruble for a few months
The crowd moved out of the stadium in a continuous stream.	the crowd moved as a liquid out of the stadium	entailment	the crowd flowed out of the stadium
The sky turned pink.	the sky glowed with rosy splendor	entailment	the sky flushed with rosy splendor
Develop the young child's personality traits.	develop the young child's character	entailment	form the young child's character
The journalists were prevented from speaking freely.	the press was silenced	entailment	the press was gagged
The moon's reflection on the lake's surface was visible.	the moon showed its reflection in the lake's surface	entailment	the moon glared back at itself from the lake's surface
The sun shone brightly and intensely upon us.	the sun shone brightly down on us	entailment	the sun glared down on us
Her face was warm and red after she exited the sauna.	her face shined when she came out of the sauna	entailment	her face glowed when she came out of the sauna
This story will capture your attention.	this story will interest you	entailment	this story will grab you
The conversation gradually shifted to the topic of politics.	the subject of the conversation changed to politics	entailment	the conversation gravitated towards politics
He tried to think of a link.	his mind attempted to make the connection	entailment	his mind groped to make the connection
The intense rainfall eroded the top layer of the ground.	the heavy rain made channels in the soil.	entailment	the heavy rain guttered the soil.
Make one's goals and abilities work together.	make one's goals compatible with one's abilities	entailment	harmonize one's goals with one's abilities
These rivers originate from a mountainous area in the Himalayas.	these rivers originate from a mountain range in the himalayas	entailment	these rivers head from a mountain range in the himalayas
The wheat's heads developed early this year.	the wheat came up from the soil early this year	entailment	the wheat headed early this year
He gave him a large amount of work.	he burdened him with work	entailment	he heaped him with work
The oscillator searches for the precise frequency.	the oscillator moves in a state of instability about the correct frequency	entailment	the oscillator hunts about the correct frequency
The rich people's showy lifestyle causes the poor to feel angry.	the ostentatious way of living of the rich triggers the hatred of the poor	entailment	the ostentatious way of living of the rich ignites the hatred of the poor
The way they speak makes us think they are telling the truth.	their language makes us consider believing them	entailment	their language inclines us to believe them
His laughter makes everyone in the same room laugh.	his laughter spreads to everyone who is in the same room	entailment	his laughter infects everyone who is in the same room
The charges were exaggerated.	the charges were exaggerated	entailment	the charges were inflated
Increase the amount of money in circulation.	increase the quantity of the currency	entailment	inflate the currency
He made the performance more lively.	he brought novelty into the performance	entailment	he injected new life into the performance
She had to manage her job and her children simultaneously.	she had to manage her job and her children at the same time	entailment	she had to juggle her job and her children
The recoil of the gun pushed my shoulder backwards.	the gun recoiled into my shoulder.	entailment	the gun kicked back into my shoulder.
The businessman illegally transferred millions of dollars.	the businessman stole millions of dollars	entailment	the businessman kited millions of dollars
This may result in you being placed in a correctional facility.	this may result in your being in jail	entailment	this may land you in jail
Create the initial structure for a new health care plan.	make the start for a new health care plan	entailment	lay the foundation for a new health care plan
Place a responsibility on someone.	give someone a responsibility	entailment	lay a responsibility on someone
Someone gave the information to the newspaper without authorisation.	the news were revealed secretly to the paper	entailment	the news were leaked to the paper
The news was revealed even though he tried to keep it hidden.	the news was revealed publicly despite his secrecy	entailment	the news leaked out despite his secrecy
Westerns have a quality that resembles gladiatorial combat and is not affected by the passage of time.	Westerns have a violent-like-gladiator-combat , timeless quality .	entailment	‘ Westerns have a gladiatorial , timeless quality .
The seller asked for £45,000 and I was not surprised that the sale did not happen immediately.	£45,000 was the asking price and I was not surprised that the sale , so to speak , was delayed .	entailment	£45,000 was the asking price and I was not surprised that the sale , so to speak , hung fire .
Primal Scream is not a name that would make you anticipate self-centred acoustic sketches.	Primal Scream Not a name which would lead you to expect self-absorbed acoustic pieces of music .	entailment	Primal Scream Not a name which would lead you to expect self-absorbed acoustic doodlings .
London's leading pair, feeling annoyed by this, made 30 September feel like the longest afternoon.	London 's leading pair , as if annoyed by this , turned 30 September into the longest afternoon .	entailment	London 's leading pair , as if piqued by this , turned 30 September into the longest afternoon .
The person speaking on the other end of the line was clearly in a state of heightened emotion, and it required a moment for the listener to comprehend the information being conveyed.	The voice at the other end was plainly over-excited and it took him a minute to separate into discrete units what he was being told .	entailment	The voice at the other end was plainly over-excited and it took him a minute to disentangle what he was being told .
An insect landed on the vacant, unblinking helmet's transparent covering, and moved across the surface.	A fly landed on the empty , shiny vizor , and crawled across it .	entailment	A fly landed on the empty , staring vizor , and crawled across it .
The marks on the floor covering have remained after each alteration of the label.	The stains on the carpet have outlasted every name change .	entailment	The stains on the carpet have survived every name change .
Paula leaned against the table used for cutting, attempting to appear relaxed and unconcerned.	Paula stayed in an elevated position against the cutting table trying to look nonchalant .	entailment	Paula perched herself against the cutting table trying to look nonchalant .
Find a 1980 Toyota Corolla or 1982 Nissan Sunny that has not been affected by rust, and you can purchase it with certainty.	Find a 1980 Toyota Corolla or 1982 Nissan Sunny that has not yielded to rust , and you can buy with confidence .	entailment	Find a 1980 Toyota Corolla or 1982 Nissan Sunny that has not succumbed to rust , and you can buy with confidence .
A dog's loud, empty-sounding bark came from one of the stone sheds, but there was no visible activity near the buildings.	The muffled barking of a dog came from one of the stone sheds , but there was no sign of life around the buildings .	entailment	The hollow barking of a dog came from one of the stone sheds , but there was no sign of life around the buildings .
Recently, there has been an additional aspect, which is partly exaggerated by the media and politicians, and partly a genuine issue: drugs.	Recently , of course , there has been an added dimension — part given excessive and meaningless words by media and politicians , part real : drugs .	entailment	Recently , of course , there has been an added dimension — part media-and-politician inflated , part real : drugs .
Secondly, this would guarantee that employees benefited from legally protected entitlements and diminish the importance of union privileges.	Second , it would ensure that workers enjoyed positive rights under law and reduce the emphasis of union exemptions from specified duties .	entailment	Second , it would ensure that workers enjoyed positive rights under law and reduce the emphasis of union immunities .
Completely tired and lacking energy.	Very tired .	entailment	Exhausted .
They convince their parents with a positive and optimistic view of the world, which makes their parents feel more confident and secure.	They win their parents over with an optimistic vision of the world which is decidedly reassuring .	entailment	They win their parents over with a rose-tinted vision of the world which is decidedly reassuring .
No matter; only the accents change — and the clothing: here, the squares wear slacks, the good guys blue-jeans.	No matter ; only the accents change — and the pants : here , the socially conventional people wear slacks , the good guys blue-jeans .	entailment	No matter ; only the accents change — and the pants : here , the squares wear slacks , the good guys blue-jeans .
Other organizations could not be included but could still be influenced by the Central Office.	Other organizations could not be incorporated but could still be brought within the Central Office orbit .	entailment	Other organizations could not be absorbed but could still be brought within the Central Office orbit .
Nor, if we are in a state of rationality, because we desire to reach a state of intoxication.	Nor , if we are in civilised mindset , because we wish to become drunk .	entailment	Nor , if we are in civilised cast of mind , because we wish to become drunk .
Was it even now following them, moving silently from one hiding place to another, like a tiger in the city?	Was it even now secretly following them , moving soundlessly from cover to cover , like a tiger in the steel jungle ?	entailment	Was it even now shadowing them , moving soundlessly from cover to cover , like a tiger in the steel jungle ?
Berry's songs are convincing symbols of rock'n'roll rebellion or, at any rate, young people's pursuit of pleasure.	Berry 's songs are plausible representations of rock'n'roll rebellion or , at any rate , youthful hedonism .	entailment	Berry 's songs are plausible emblems of rock'n'roll rebellion or , at any rate , youthful hedonism .
The person appears to be fully alert and could have risen from their bed.	seems to be awake and very alert could of got up	entailment	seems to be wide awake could of got up
Rocastle passed the ball to Thomas with a precise movement, allowing Thomas to run towards the goal, but Rhodes quickly left his position to block the shot.	A neat step-over by Rocastle sent Thomas hurtling in on goal but Rhodes moved sharply off his line to get in the way of the shot .	entailment	A neat step-over by Rocastle sent Thomas hurtling in on goal but Rhodes moved sharply off his line to smother the shot .
I estimate that she survived for approximately two years following the stroke, according to Gordon.	Well I suppose she lived er a couple of years after the stroke Gordon .	entailment	Well I reckon she lived er a couple of years after the stroke Gordon .
Buzz said in a sharp tone that the amount of paperwork has increased after the trust assumed control.	‘ We 've had more paperwork , not less , since the trust took over , ’ Buzz said severely .	entailment	‘ We 've had more paperwork , not less , since the trust took over , ’ Buzz said tartly .
You might have thought this was the police pretending and intimidating.	You might have assumed this was the police scaring with a false show of strength and bullying .	entailment	You might have assumed this was the police bluffing and bullying .
I will help you so that you do not have to carry them.	Except for you , except for you carrying them .	entailment	Save you , save you carrying them .
She fell asleep while listening to music coming from the room below.	She fell asleep to the sound of music emanating from the drawing-room .	entailment	She fell asleep to the sound of music drifting upwards from the drawing-room .
You have to hope that the blankness will gradually disappear and allow life to enter.	You have to hope that its blankness will slowly clear away and let life in .	entailment	You have to hope that its blankness will slowly dissolve and let life in .
The process of getting rid of harmful substances is a difficult issue that industrialised countries need to address.	The disposal of toxic wastes is one of the most difficult problems for industrialised societies to solve .	entailment	The disposal of toxic wastes is one of the most intractable problems facing industrialised societies .
Let those who are strict and negative about pleasure criticize, reject or ignore these desires; they are missing out.	Let puritans and pessimists damn , disapprove or dismiss these strong desires ; that is their loss .	entailment	Let puritans and pessimists damn , disapprove or dismiss these appetites ; that is their loss .
Avon walks carefully.	Avon proceeds warily .	entailment	Avon treads warily .
Although there were numerous and diverse periods of intense action during the initial 40 minutes, Arsenal appeared to be relatively safe, even if they were not particularly motivated.	Despite many and varied sudden activities in the first 40 minutes , Arsenal seemed reasonably secure if not inspired .	entailment	Despite many and varied flurries of activity in the first 40 minutes , Arsenal seemed reasonably secure if not inspired .
The house's red brick exterior was not illuminated by any light of a golden colour.	No golden light surrounded the red brick of the house .	entailment	No golden light bathed the red brick of the house .
Does the 'serious physical injury' rule broaden the definition of murder excessively?	Does the ‘ grievous bodily harm ’ rule add too much to the definition of murder ?	entailment	Does the ‘ grievous bodily harm ’ rule extend the definition of murder too far ?
Adam closed the front door and remained there for a moment as if he was unable to move.	Adam closed the front door and stood there for a moment as if he could not pull himself away .	entailment	Adam closed the front door and stood there for a moment as if he could not wrench himself away .
The first attempt successfully contained the substance.	This was conveniently summarized briefly in the first try .	entailment	This was conveniently encapsulated in the first try .
But the act of assuming false positions and making false claims extended to a much wider range of organizations.	But ‘ pretending to have an opinion ’ went far beyond the unions .	entailment	But ‘ posturing and pretending ’ went far beyond the unions .
Secondly, this would strengthen the perception and fundamental nature of the Intifada as a positive and beneficial influence, rather than a harmful one.	Second , it would strengthen the image and essence of the Intifada as a constructive , not a destructive , force .	entailment	Second , it would consolidate the image and essence of the Intifada as a constructive , not a destructive , force .
The Spirit, bending down towards the earth,	And the Spirit , lowering itself earthward ,	entailment	And the Spirit ,  stooping  earthward ,
Drew a curved line for it.	Lightly drew a winding pathway for it ,	entailment	Traced  a winding pathway for it ,
Then a cloud that is the color of snow expanded.	Then a snow-white cloud developing ,	entailment	Then a snow-white cloud  unfolding  ,
It reached the highest point in the sky.	Till it reached the top of heaven ,	entailment	Till it  touched  the top of heaven ,
Now you have discovered that we are the most powerful.	Now you discover that we are strongest ,	entailment	Now you  find  that we are strongest ,
Only adding fuel to the fire made the flames grow in intensity.	Only caused the fire to burn brighter ,	entailment	Only  made  the fire burn brighter ,
The hills were stroked with a gentle, smooth touch.	Added smoothness to the rugged hills ,	entailment	Touched  the rugged hills with smoothness ,
His eyes were fixed on the train tracks.	On their tracks his eyes were fixated ,	entailment	On their tracks his eyes were  fastened  ,
His heart rate increased rapidly.	And his heart within him pumped rapidly ,	entailment	And his heart within him  fluttered  ,
Hiawatha was full of awe.	Experiencing great awe was Hiawatha	entailment	Filled  with awe was Hiawatha
Mudjekeewis was experiencing a state of happiness.	Experiencing great joy was Mudjekeewis	entailment	Filled  with joy was Mudjekeewis
He witnessed his past as a young person appear in front of him.	Saw his youth rebel before him	entailment	Saw his youth  rise  up before him
You remind me of past times.	You bring back the days past ,	entailment	You bring back the days  departed  ,
You remind me of my passionate younger years.	You restore my youth of passion ,	entailment	You  bring  back my youth of passion ,
In the past.	In the days long since past ,	entailment	In the days long since  departed  ,
Provide the passionate and enthusiastic minds of young males with knowledge and information.	Occupy the fiery brains of young men ?	entailment	Fill  the fiery brains of young men ?
When he was touched, he felt a renewed sense of bravery.	At his touch he experienced new courage	entailment	At his touch he  felt  new courage
Until the darkness surrounded them.	Till the darkness surrounded them ,	entailment	Till the darkness  fell  around them ,
The object forms when it comes into contact with the ground.	Assuming shape when earth it touches ,	entailment	Taking  shape when earth it touches ,
Until the absence of light surrounded them.	Till the darkness surrounded them ,	entailment	Till the darkness  fell  around them ,
Until the absence of light surrounds us.	Till the darkness surrounds us ,	entailment	Till the darkness  falls  around us ,
He was afraid that he would lose his strength.	Fearing lest he should lose his strength ,	entailment	Fearing lest his strength should  fail  him ,
The landscape rotated around him.	Round about him enveloped the landscape ,	entailment	Round about him  spun  the landscape ,
His powerful heart jumped inside his body.	And he became very happy ,	entailment	And his strong heart  leaped  within him ,
The red horizon glowed brightly.	Shone like fire and flared the red horizon ,	entailment	Blazed  and flared the red horizon ,
The red horizon was illuminated with bright light.	Blazed and shone out suddenly the red horizon ,	entailment	Blazed and  flared  the red horizon ,
And he communicated the information to the citizens.	And made the people know about	entailment	And  made  known unto the people
The pathway extended in a straight line between the two.	Straight between them extended the pathway ,	entailment	Straight between them  ran  the pathway ,
Could not create a negative relationship between them.	Could not create ill-will between them ,	entailment	Could not  breed  ill-will between them ,
They shared their thoughts and feelings with each other.	For they listened to each other 's advice ,	entailment	For they  kept  each other 's counsel ,
Now he excited their souls to a state of emotional intensity.	Now he made their souls passionate ,	entailment	Now he  stirred  their souls to passion ,
Now he made them feel sorry.	Now he humbled them to pity .	entailment	Now he  melted  them to pity .
All the people became more compassionate.	All the men were made kinder and gentler	entailment	All the hearts of men were  softened
His physical power combined with his moral virtue.	For his strength united with goodness .	entailment	For his strength  allied  to goodness .
Rose did not respond with anger.	Rose , but gave no angry answer ,	entailment	Rose , but  made  no angry answer ;
Where a small stream guided them forward.	Where they followed a brooklet onward ,	entailment	Where a brooklet  led  them onward ,
They did not respond to the challenge.	To their challenge gave no answer ,	entailment	To their challenge  made  no answer ,
The season of summer is approaching.	For the Summer-time will soon begin ,	entailment	For the Summer-time is  coming  ,
A sound was heard, followed by a cry of fear.	A sound let out , a cry of horror ,	entailment	Went  a sound , a cry of horror ,
His thoughts helped him move forward.	For his thoughts functioned as paddles for him ,	entailment	For his thoughts as paddles  served  him ,
His desires provided him with direction.	And his wishes were useful for guiding him ;	entailment	And his wishes  served  to guide him ;
His desires directed him.	And his wishes served to give him a sense of direction ;	entailment	And his wishes served to  guide  him ;
The water reached the area where the rib bones are located.	Till the waves flowed through the rib-bones ,	entailment	Till the waves  washed  through the rib-bones ,
With their hot air expelled from their lungs, they responded.	With their fiery breath gave an answer :	entailment	With their fiery breath  made  answer :
The moon, which was at a low angle in the sky, was visible to him.	Till the level moon shone constantly on him	entailment	Till the level moon  stared  at him
The blows he delivered were not harmful to it.	Harmless landed the blows he dealt it	entailment	Harmless  fell  the blows he dealt it
The war-club, which was heavy, fell without causing harm.	Harmless struck the heavy war-club ;	entailment	Harmless  fell  the heavy war-club ;
Mosses hung from the branches of the tree.	From whose branches hanged the mosses ,	entailment	From whose branches  trailed  the mosses ,
The person who caused the high body temperature.	Him who gave the fiery fever ,	entailment	Him , who  sent  the fiery fever ,
He ran faster than he could physically move.	And his heart lasted longer than his footsteps ;	entailment	And his heart  outran  his footsteps ;
And then he continued to speak, enunciating each word deliberately.	And then said additionally , speaking slowly ,	entailment	And then  added  , speaking slowly ,
And he provided a response with a serious expression.	And gave an answer very gravely :	entailment	And  made  answer very gravely :
Please, express your emotions, Minnehaha!	Speak sincerely , Minnehaha !	entailment	Let your heart  speak  , Minnehaha ! "
He slowed down his walking speed.	Though his pace he limited and slackened	entailment	Though his pace he  checked  and slackened
He slowed down his walking speed.	Though his pace he checked and gradually decreased in intensity	entailment	Though his pace he checked and  slackened
That the time might go by more happily.	That the time might progress more gayly ,	entailment	That the time might  pass  more gayly ,
That the time may go by more happily.	That the time may progress more gayly ,	entailment	That the time may  pass  more gayly ,
That the time may go by more happily.	That the time may advance more gayly ,	entailment	That the time may  pass  more gayly ,
As the springs emerge from the ground to receive sunlight.	As the springs to be exposed to the sunshine ,	entailment	As the springs to  meet  the sunshine ,
When the clouds block sunlight, creating areas of darkness on the ground.	When the clouds make shadows on it !	entailment	When the clouds  drop  shadows on it !
Then my heart, which was previously in a state of distress, experiences a positive change and becomes more cheerful.	Then my troubled heart is made more cheerful ,	entailment	Then my troubled heart is  brightened  ,
Envious of the clapping directed at him,	Jealous of the applause they made for him ,	entailment	Jealous of the applause they  gave  him ,
If you would only believe him.	Would you only believe him ,	entailment	Would you only  give  him credence ,
That the time may move more happily.	That the time may advance more gayly ,	entailment	That the time may  pass  more gayly ,
The water turned red.	All the water given a crimson color !	entailment	All the water  flushed  with crimson !
They sensed the increase in intensity.	And they experienced it rising , rising	entailment	And they  felt  it rising , rising ,
They felt the temperature increasing.	And they felt it increasing, increasing	entailment	And they felt it  rising  , rising ,
I was unable to perceive your emotional enthusiasm.	Could not experience your heart of passion	entailment	Could not  see  your heart of passion ,
Of the days that were filled with happiness after the event.	Of the happy days that occurred afterward	entailment	Of the happy days that  followed  ,
The darkness enveloped the area like a piece of clothing.	Surrounded by darkness like a garment	entailment	Robed  with darkness as a garment .
The leaves of the trees moved in the wind, making a sound that resembled laughter.	Till the tree-tops shook from the laughter of creatures on them	entailment	Till the tree-tops  shook  with laughter ,
When the night, which was devoid of sound, began.	When the noiseless night began	entailment	When the noiseless night  descended
The darkness surrounded her.	Guskewau , the darkness , surrounded her	entailment	Guskewau , the darkness ,  wrapped  her
The cornfields were filled with laughter.	Till the cornfields reverberated with laughter	entailment	Till the cornfields  rang  with laughter ,
The song that this shape made me think of.	And the song this shape reminded one of	entailment	And the song this shape  suggested
I have influenced you in this way.	Such the spell I made upon you	entailment	Such the spell I  cast  upon you ,
The sound of silence filled the entire planet.	Made everything on the earth silent	entailment	Covered  all the earth with silence ,
The season of Spring arrived, and the entire forest	Began the Spring , and all the forest	entailment	Came  the Spring , and all the forest
The clouds are removed from the sky.	As the clouds are cleared from heaven	entailment	As the clouds are  swept  from heaven ,
As the frozen water is removed from rivers.	As the ice is carried from rivers	entailment	As the ice is  swept  from rivers ,
The sky was high above him.	Far above him things moved in the heavens	entailment	Far above him  swam  the heavens ,
My revenge will not physically touch him.	That my vengeance shall not affect him !	entailment	That my vengeance shall not  reach  him ! "
He responded cautiously.	With reserve he thus gave an answer	entailment	With reserve he thus  made  answer :
The object contracted.	Till it pulled itself together	entailment	Till it  drew  itself together ,
It changed its shape and appearance.	Till it acquired the form and features	entailment	Till it  took  the form and features
He hit the doorways with his weapon.	With his war-club struck the doorways	entailment	With his war-club  smote  the doorways ,
Kwasind felt sleepy.	Kwasind experienced a drowsiness	entailment	Fell  a drowsiness on Kwasind ;
The winter storm was very loud and strong.	Raged and made a loud resounding noise the wintry tempest	entailment	Raged and  roared  the wintry tempest ,
Disasters do not occur in isolation.	So disasters occur not singly	entailment	So disasters  come  not singly ;
Their facial expressions did not alter.	Not a change happened to their features	entailment	Not a change  came  o'er their features ;
We have tested you.	We have made you undergo the trial	entailment	We have  put  you to the trial ,
He collapsed and was unable to get up due to physical frailty.	Fell , and could not improve their situation from weakness	entailment	Fell , and could not  rise  from weakness ,
She covered her face and remained silent.	Hid her face , but gave no answer	entailment	Hid her face , but  made  no answer ;
When they looked at her,	At the looks they gave to her	entailment	At the looks they  cast  upon her ,
Let us spend the night in each other's company.	Let us spend the night together	entailment	Let us  pass  the night together ,
All the fields are filled with flowers that are moving in the wind.	All the meadows move back and forth repeatedly with blossoms	entailment	All the meadows  wave  with blossoms ,
As they were talking, the night ended.	While they spake , the night ended	entailment	While they spake , the night  departed  :
The season of Spring arrived, and with it, all the beautiful and vibrant colours and life that it brings.	The Spring happened with all its splendor	entailment	Came  the Spring with all its splendor ,
The sun illuminated his face.	Shone the sunshine on his features	entailment	Fell  the sunshine on his features ,
The evening became darker and cooler.	Began the evening 's dusk and coolness	entailment	Fell  the evening 's dusk and coolness ,
He is in pain; he rolls his eyes.	Torments him ; round he looks with his baleful eyes	entailment	Torments him ; round he  throws  his baleful eyes
And the state of being inactive can never exist, positive anticipation never arrives.	And rest can never stay , hope never comes	entailment	And rest can never  dwell  , hope never comes
And people who are tired can never relax, and hope never arrives.	And rest can never dwell , hope is never felt	entailment	And rest can never dwell , hope never  comes
He learned the knowledge and beliefs of his tribe.	he learned the knowledge or beliefs of his tribe.	entailment	he absorbed the knowledge or beliefs of his tribe.
He paid for the costs of the accident.	he took the costs for the accident.	entailment	he absorbed the costs for the accident.
The sales tax is added to the state income tax.	the sales tax is incorporated into the state income tax.	entailment	the sales tax is absorbed into the state income tax.
The immigrants were rapidly integrated into the social structure.	the immigrants were quickly assimilated into society.	entailment	the immigrants were quickly absorbed into society.
You have to follow the guidelines.	you must obey the rules.	entailment	you must adhere to the rules.
The people who lived in this village followed the Catholic religion.	the residents of this village were religious about catholicism.	entailment	the residents of this village adhered to catholicism.
There is no way to solve this problem.	this problem has no solution	entailment	this problem admits of no solution
She expressed her views on welfare.	she broadcasted her opinions on welfare	entailment	she aired her opinions on welfare
This concept will not achieve any significant outcome.	this idea will never become anything	entailment	this idea will never amount to anything
I started working on the problem immediately after I woke up.	i dealt with the problem as soon as i got out of bed	entailment	i attacked the problem as soon as i got out of bed
Which candidate do you support?	which horse are you supporting?	entailment	which horse are you backing?
She was overwhelmed by numerous problems, which caused her to lose motivation.	she was overwhelmed by so many problems that she got discouraged	entailment	she was besieged by so many problems that she got discouraged
Meteors moved quickly through the atmosphere, creating a bright trail of light.	meteors burned across the atmosphere.	entailment	meteors blazed across the atmosphere.
The difference between the two theories became less clear.	the distinction between the two theories became less dinstinguishable 	entailment	the distinction between the two theories blurred
Do not eat your food too quickly!	don't eat your food too fast!	entailment	don't bolt your food!
The government yielded to the military's demands.	the government succumb to the military pressure	entailment	the government bowed to the military pressure
He renovated the old house extensively, transforming it into a vibrant and modern home.	he brought new life into the old house	entailment	he breathed new life into the old house
The new synthetic fabric is permeable and suitable for hot weather clothing.	our new synthetic fabric allows sweat to evaporate and is perfect for summer wear	entailment	our new synthetic fabric breathes and is perfect for summer wear
This wine from Bordeaux, which is not commonly found, should be uncorked and exposed to air for 120 minutes before consumption.	this rare bordeaux must be allowed to be exposed to the air for at least 2 hours	entailment	this rare bordeaux must be allowed to breathe for at least 2 hours
The office is filled with people engaging in various tasks and projects, creating a lively and busy atmosphere.	this office is full of activity	entailment	this office is buzzing with activity
He pressed the servant's button.	he signalled the servant with a buzz	entailment	he buzzed the servant
She made all the men fall in love with her.	she made all the men fall in love with her	entailment	she captured all the men's hearts
The judge put him in prison.	the judge sentenced him to stay in jail	entailment	the judge clapped him in jail
They used their hands and feet to climb to the summit of the mountain.	they climbed their way to the top of the mountain.	entailment	they clawed their way to the top of the mountain.
She grabbed the doorknob with her hand.	she scratched the doorknob with nails.	entailment	she clawed the doorknob.
The politician attacked his rival.	the politician harmed his rival politically.	entailment	the politician clawed his rival.
The number of sales increased following the reduction in prices.	sales were increasing after prices were lowered	entailment	sales were climbing after prices were lowered
The path ascended the entire length of the hill.	the path ascended all the way to the top of the hill	entailment	the path climbed all the way to the top of the hill
Prices increased rapidly.	prices increased steeply	entailment	prices climbed steeply
These operations are blocking the market.	the market is being obstructed by these operations	entailment	the market is being clogged by these operations
She was so afraid that she couldn't think clearly.	fear impaired her mind	entailment	fear clogged her mind
My emotions influence my ability to make an impartial decision regarding this matter.	my personal feelings affect my judgment in this case	entailment	my personal feelings color my judgment in this case
His political beliefs influence the content of his lectures.	his political ideas make his lectures biased	entailment	his political ideas color his lectures
The rooms were connected.	the rooms were interconnected 	entailment	the rooms communicated
His dedication to his ill spouse resulted in a solitary life.	his devotion to his sick wife caused him to have a lonely existence	entailment	his devotion to his sick wife condemned him to a lonely existence
Her feelings became more intense and concentrated.	her feelings became more compact	entailment	her feelings condensed
The fire destroyed the building.	the fire destroyed the building	entailment	the fire consumed the building
The comedian made the crowd laugh uncontrollably.	the comedian caused the crowd to shake violently because of laughter	entailment	the comedian convulsed the crowd
You can rely on me to provide assistance whenever you need it.	you can have confidence in me to help you any time	entailment	you can count on me to help you any time
The old cheese was covered in moving maggots.	the old cheese was covered by maggots	entailment	the old cheese was crawling with maggots
The speech concluded the meeting.	the speech culminated the meeting	entailment	the speech crowned the meeting
A metal device for indicating wind direction is located at the highest point of the building.	a weather vane is on the top of the building	entailment	a weather vane crowns the building
She felt very sad and disappointed when he declined her invitation.	she was depressed by his refusal of her invitation	entailment	she was crushed by his refusal of her invitation
Seurat completed the development of pointillism.	seurat brought pointillism to its best.	entailment	seurat culminated pointillism.
The rejection made him feel suddenly and deeply disappointed.	discourged by the refusal	entailment	dashed by the refusal
He realized she had been unfaithful to him.	it became apparent to him that she had betrayed him	entailment	it dawned on him that she had betrayed him
The era of computers had begun.	the age of computers had started	entailment	the age of computers had dawned
The negative review of his work made him feel less confident in himself.	the bad review of his work reduced his self-confidence	entailment	the bad review of his work deflated his self-confidence
The new measures caused the economy to decrease in size and value.	the new measures reduced activities in the economy	entailment	the new measures deflated the economy
The excess of oil caused gas prices to decrease.	the glut of oil lowered gas prices	entailment	the glut of oil depressed gas prices
The absence of rain caused the water level in the reservoir to decrease.	the lack of rain had lowered the water level in the reservoir	entailment	the lack of rain had depressed the water level in the reservoir
She created a convincing reason for her absence from school that day.	she made a good excuse for not attending classes that day.	entailment	she designed a good excuse for not attending classes that day.
A fire destroyed our home.	fire had destroyed our home	entailment	fire had devoured our home
She read his novels with great enthusiasm and speed.	she finished reading his novels	entailment	she devoured his novels
I am unable to process all this information.	i cannot understand all this information	entailment	i cannot digest all this information
The government condensed the entire law into a code.	the government summarized the entire law into a code	entailment	the government digested the entire law into a code
He drank three martinis before dinner.	he drank three martinis before dinner.	entailment	he downed three martinis before dinner.
Some people can eat a pound of meat in one sitting.	some people can consume a pound of meat in the course of one meal.	entailment	some people can down a pound of meat in the course of one meal.
Stock prices are gradually increasing.	stock prices are varying higher	entailment	stock prices are drifting higher
My son travelled aimlessly in California for years before he enrolled in law school.	my son lived without a purpose for years in california before going to law school	entailment	my son drifted around for years in california before going to law school
The stock market increased in value.	the stock market varied upward	entailment	the stock market drifted upward
The mother listens attentively to every word her son says on stage.	the mother pays close attention to in every word of her son on the stage	entailment	the mother drinks in every word of her son on the stage
I was overwhelmed with a large amount of work.	i was overwhelmed by work	entailment	i was drowned in work
She drank alcohol to forget her problems.	she got rid of her trouble with alcohol	entailment	she drowned her trouble in alcohol
As she got older, she became less interested in travelling.	middle age made her lose her appetite for travel	entailment	middle age dulled her appetite for travel
The company fired him after many years of employment.	the company got rid of him after many years of service	entailment	the company dumped him after many years of service
Some positive outcomes were discovered through the research.	some nice results became apparent from the study	entailment	some nice results emerged from the study
The event was firmly embedded in her memory.	the event impressed itself into her memory	entailment	the event engraved itself into her memory
The Ottoman Empire systematically killed Armenians in 1915.	the turks got rid of the armenians in 1915	entailment	the turks erased the armenians in 1915
The boss became very angry when he was informed of the secretary's resignation.	the boss became outrageous when he heard of the resignation of the secretary	entailment	the boss exploded when he heard of the resignation of the secretary
The Middle East is experiencing political and social instability.	the middle east is changing gradually 	entailment	the middle east is fermenting
The child felt proud.	make the child proud	entailment	fill the child with pride
The night sky suddenly lit up with bright flashes from the large-scale attack.	the night sky was brightened with the massive bombardment.	entailment	the night sky flared with the massive bombardment.
The most recent information is transmitted to every command post.	the latest intelligence is spread fast to all command posts	entailment	the latest intelligence is flashed to all command posts
The Republicans are suggesting a tax reform.	the republicans are suggesting the idea of a tax reform tentatively	entailment	the republicans are floating the idea of a tax reform
The dancer moved gracefully across the stage.	the dancer moved lightly across the stage	entailment	the dancer floated across the stage
The government allowed the ruble to fluctuate freely in the market for a few months.	the government caused the ruble to fluctuate for a few months	entailment	the government floated the ruble for a few months
The crowd moved out of the stadium in a continuous stream.	the crowd went out of the stadium	entailment	the crowd flowed out of the stadium
The sky turned pink.	the sky glowed with rosy splendor	entailment	the sky flushed with rosy splendor
The journalists were prevented from speaking freely.	the press was silenced	entailment	the press was gagged
The moon's reflection on the lake's surface was bright and clear.	the moon reflected itself from the lake's surface	entailment	the moon glared back at itself from the lake's surface
The sun emitted bright light towards us from above.	the sun shone intensively on us	entailment	the sun glared down on us
Her face was warm and red after she left the sauna.	her face became shining when she came out of the sauna	entailment	her face glowed when she came out of the sauna
This story will capture your attention.	this story will catch your attention	entailment	this story will grab you
The conversation gradually shifted to the topic of politics.	the conversation gradually became relevant to politics	entailment	the conversation gravitated towards politics
The intense rainfall caused the soil to erode and form channels.	the heavy rain wore the soil to the gutter.	entailment	the heavy rain guttered the soil.
Make one's goals and abilities work together.	balance one's goals with one's abilities	entailment	harmonize one's goals with one's abilities
These rivers originate from a mountainous area in the Himalayan mountain system.	these rivers come from a mountain range in the himalayas	entailment	these rivers head from a mountain range in the himalayas
The wheat's heads appeared sooner than usual this year.	the wheat grew to the head early this year	entailment	the wheat headed early this year
He gave him a large amount of work.	he gave him a lot of work	entailment	he heaped him with work
The oscillator searches for the correct frequency.	the oscillator searches for the correct frequency	entailment	the oscillator hunts about the correct frequency
The lavish lifestyle of the wealthy causes the poor to feel anger and resentment.	the ostentatious way of living of the rich causes the hatred of the poor	entailment	the ostentatious way of living of the rich ignites the hatred of the poor
The way they speak makes us think they are telling the truth.	their language intends to cause us to believe them	entailment	their language inclines us to believe them
His laughter makes everyone in the same room laugh.	his laughter affects everyone who is in the same room	entailment	his laughter infects everyone who is in the same room
The charges were exaggerated.	the charges increased	entailment	the charges were inflated
Increase the amount of money in circulation.	increase the amount of currency	entailment	inflate the currency
He revitalized the performance.	he incorporated new life into the performance	entailment	he injected new life into the performance
She had to manage her job and her children simultaneously.	she had to deal with her job and her children at the same time	entailment	she had to juggle her job and her children
The recoil of the gun pushed against my shoulder.	the gun sprang back into my shoulder.	entailment	the gun kicked back into my shoulder.
The businessman illegally transferred millions of dollars.	the businessman got millions of dollars by using a bad check	entailment	the businessman kited millions of dollars
This may result in you being imprisoned.	this may cause you to be in jail	entailment	this may land you in jail
Create the initial structure for a new health care plan.	cause to have the foundation for a new health care plan	entailment	lay the foundation for a new health care plan
Place a responsibility on someone.	impose a responsibility on someone	entailment	lay a responsibility on someone
Someone gave the information to the newspaper without authorisation.	the news were told to the paper	entailment	the news were leaked to the paper
The news was revealed despite his efforts to keep it hidden.	the news became known by the public despite his secrecy	entailment	the news leaked out despite his secrecy
We can physically support ourselves by resting on this man's body.	we can believe the support of this man	entailment	we can lean on this man
The rural areas of Britain require the establishment of remote work facilities, and Christian Wolmar asserts that the country is slow in this regard.	The revolution the countryside needs : Christian Wolmar says Britain is straggling in setting up ‘ telecottages ’	entailment	The revolution the countryside needs : Christian Wolmar says Britain is lagging behind in setting up ‘ telecottages ’
I found his speech to be the weakest of all the presentations given that day.	His speech struck me as the lamest of the day .	entailment	His speech struck me as the feeblest of the day .
'No,' he said, then smiled at me in a patronising way.	‘ No , ’ he said helpfully , then formed a patronising smile at me .	entailment	‘ No , ’ he said helpfully , then bestowed a patronising smile on me .
He identifies the business's requirements and recommends a solution.	He finds out what the needs of the business are , and makes a plan to solve the problem .	entailment	He finds out what the needs of the business are , and prescribes the cure .
Ellen expressed her opinion that the other person would benefit from self-reflection.	‘ I think she 'd do better to understand herself , ’ Ellen said ironically.	entailment	‘ I think she 'd do better to understand herself , ’ Ellen said tartly .
In the regions outside the capital, medical services for unexpected illnesses and injuries were available in many places, but the prohibition on urgent medical procedures was made more severe.	Outside the capital , accident and emergency services were being provided in most areas , but the ban on emergency work was limited .	entailment	Outside the capital , accident and emergency services were being provided in most areas , but the ban on emergency work was tightened .
'Oh, and there is one additional piece of information that you can be certain of,' he said with a sour expression.	Oh , and there 's one more thing you can be sure of , ’ he added ironically.	entailment	Oh , and there 's one more thing you can be sure of , ’ he added sourly .
We pressured them from the beginning and did not allow them to relax.	We worried them from the first minute and did n't give them any breathing space .	entailment	We rattled them from the first minute and did n't give them any breathing space .
But while the Department of Trade and Industry would overrule the Treasury, a new, influential Department of Consumer Affairs would oppose the Department of Trade and Industry.	But while the DTI would override the Treasury , a new ‘ powerful Department of Consumer Affairs ’ would oppose the DTI .	entailment	But while the DTI would override the Treasury , a new ‘ powerful Department of Consumer Affairs ’ would antagonise the DTI .
I reclined in the heather and enjoyed the gentle flow of the stream and the distinct aroma of the peat-covered earth.	Instead I lay back in the heather and enjoyed the trickle of the burn and the crisp smell of peat-laden ground .	entailment	Instead I lay back in the heather and savoured the trickle of the burn and the crisp smell of peat-laden ground .
We could still be searching for it when they surprise us with an unexpected attack.	We could still be looking for it when they surpassed us . ’	entailment	We could still be looking for it when they blow us out of the water . ’
There must be a complete recovery now, the sole benefit of which was that it could eliminate his nightmares.	There must be a total retrieval now , the one good thing about which was that it might completely get rid of his dreams .	entailment	There must be a total retrieval now , the one good thing about which was that it might banish his dreams .
No one who was at the Brewery Field ( perhaps not even the selectors ) would give two pennies for their capability to perform this action .	No one who was at the Brewery Field ( perhaps not even the selectors ) would care their ability to do so .	entailment	No one who was at the Brewery Field ( perhaps not even the selectors ) would give twopence for their ability to do so .
Documents that possibly include geographical representations, technical drawings and additional resources require individual analysis.	Manuals which may contain maps , schematic diagrams and other materials need separate consideration .	entailment	Manuals which may contain maps , schematic diagrams and other materials warrant separate consideration .
To take this action does not guarantee immediate success in achieving the goal.	Naturally , to start such a step is not necessarily to succeed immediately in realising it .	entailment	Naturally , to embark on such a step is not necessarily to succeed immediately in realising it .
Despite Mr Dobbs's continuous hard work, this is another revolution that Britain is likely to observe from a position of non-involvement.	Despite Mr Dobbs 's continuous efforts , this is another revolution which Britain is likely to be viewing from the sidelines .	entailment	Despite Mr Dobbs 's tireless efforts , this is another revolution which Britain is likely to be viewing from the sidelines .
The pitch of his voice became lower.	His voice became lower.	entailment	His voice deepened .
Therefore, the Prime Minister's admission could not be described as unwilling.	Therefore the admission which the Prime Minister requested from him could hardly be said to have been grudging .	entailment	Therefore the admission which the Prime Minister wrung from him could hardly be said to have been grudging .
Four of the absentees experienced the fidgety unease of being with the Welsh squad.	Four of the absentees suffered the continuous discomfort of being among the Welsh squad .	entailment	Four of the absentees suffered the squirming discomfort of being among the Welsh squad .
It is an unusual and contradictory base on which to construct a concept of self-governance.	It is an oddly paradoxical foundation upon which to build a theory of autonomy .	entailment	It is a curiously paradoxical foundation upon which to build a theory of autonomy .
There are few things worse than being forced to read a book you dislike.	There are few things worse than being forced to read a book you hate .	entailment	There are few things worse than being bludgeoned into reading a book you hate .
The result is similar to a long commercial for Marlboro Lights cigarettes.	The effect is rather like a larger advertisement for Marlboro Lights .	entailment	The effect is rather like an extended advertisement for Marlboro Lights .
That approach would aim to eliminate a fundamental element of Civil Service tradition.	That approach would seek to knock out the basis of Civil Service tradition .	entailment	That approach would seek to knock out a keystone of Civil Service tradition .
I studied law and meteorology last Easter, and I have recently completed courses in navigation, radiotelephony, and technical subjects, which were the most challenging.	Did law and meteorology last Easter , and now I 've finished navigation , radiotelephony , and technical — that was the most difficult . ’	entailment	Did law and meteorology last Easter , and now I 've finished navigation , radiotelephony , and technical — that was the toughest . ’
The results are concise and clearly defined, resembling high-quality linear illustrations.	The results are concise and sharply etched , like the best line drawings .	entailment	The results are terse and sharply etched , like the best line drawings .
The plane ascends slowly, with one wing tilting to the side.	The plane climbs reluctantly , one set of wings dipping cumbersomely.	entailment	The plane climbs reluctantly , one set of wings dipping drunkenly .
Workers had placed torches in various locations where the conditions were appropriate, and the torches illuminated the surrounding area, including the sky and the water's surface.	Torchlights , burning against the night sky and reflected in the water , had been set up wherever it was suitable .	entailment	Torchlights , flaring against the night sky and reflected in the water , had been set up wherever it was suitable .
Grey clouds moved across the sky above the roof, which was now the only thing that was wet and reflecting light due to the rain.	Dirty grey clouds tumbled across the sky above the slate roof , now the only thing that shone , shining with rain .	entailment	Dirty grey clouds tumbled across the sky above the slate roof , now the only thing that shone , glazed with rain .
‘When Tony could not make me reach an orgasm, he wanted to invite another woman to join us,’ Clare said.	‘ When Tony could n't get me to have orgasm, he wanted to ask another girl over , ’ Clare said .	entailment	‘ When Tony could n't get me to climax , he wanted to ask another girl over , ’ Clare said .
He learned the knowledge and beliefs of his tribe.	he absorbed the beverages of his tribe .	not_entailment	he absorbed the knowledge or beliefs of his tribe.
He paid for the costs of the accident.	he absorbed the sunlight after the accident .	not_entailment	he absorbed the costs for the accident.
The sales tax is added to the state income tax.	the dirty water is absorbed into the clean water .	not_entailment	the sales tax is absorbed into the state income tax.
The immigrants were rapidly integrated into the social structure.	the chemicals were quickly absorbed into sponges .	not_entailment	the immigrants were quickly absorbed into society.
Her interest in butterflies occupies her mind entirely.	her butterflies absorb her food completely .	not_entailment	her interest in butterflies absorbs her completely.
You are required to follow the guidelines.	you must adhere the rules to the wall .	not_entailment	you must adhere to the rules.
The people who lived in this village followed the Catholic religion.	the wax of this village adhered to fingers .	not_entailment	the residents of this village adhered to catholicism.
The problem cannot be solved.	this park admits no dogs	not_entailment	this problem admits of no solution
She expressed her views on welfare.	she aired her laundry on the roof	not_entailment	she aired her opinions on welfare
This concept will never achieve any significant result.	this budget will never amount to more than a thousand euros	not_entailment	this idea will never amount to anything
The steering wheel of my new car responds to even the gentlest pressure.	the person in my new car answers any question	not_entailment	the steering of my new car answers to the slightest touch
I started working on the problem immediately after waking up.	i attacked the mailman as soon as i got out of bed	not_entailment	i attacked the problem as soon as i got out of bed
Which candidate are you supporting?	which car are you backing up ?	not_entailment	which horse are you backing?
She was overwhelmed by numerous problems, which caused her to lose motivation.	she was besieged by so many soldiers that she gave up	not_entailment	she was besieged by so many problems that she got discouraged
She usually spoke loudly when using a microphone.	she tended to blast holes in the wall when shooting	not_entailment	she tended to blast when speaking into a microphone
Meteors moved quickly through the atmosphere, producing a trail of light.	meteors blazed through the dry forest .	not_entailment	meteors blazed across the atmosphere.
The difference between the two theories became less clear.	the ink between the two pages blurred	not_entailment	the distinction between the two theories blurred
Do not eat your food too quickly!	don't bolt from the kitchen carrying food !	not_entailment	don't bolt your food!
The government yielded to the military's demands.	the government leaders bowed to the military generals	not_entailment	the government bowed to the military pressure
He renovated the old house extensively, transforming it into a vibrant and functional space.	he breathed onto the plants in the old house	not_entailment	he breathed new life into the old house
The new artificial material has a breathable structure, making it ideal for clothing in hot weather.	our new synthetic animal breathes and is perfect for a household pet	not_entailment	our new synthetic fabric breathes and is perfect for summer wear
This wine from Bordeaux, which is not commonly found, should be uncorked and exposed to air for 120 minutes before consumption.	this rare dog from bordeaux must be allowed to breathe	not_entailment	this rare bordeaux must be allowed to breathe for at least 2 hours
The office is filled with people working on various tasks.	this bee is buzzing with activity	not_entailment	this office is buzzing with activity
He rang the bell to summon the servant.	he buzzed when the servant came near	not_entailment	he buzzed the servant
She made all the men fall in love with her.	she captured all the men's hearts and stored them in glass jars	not_entailment	she captured all the men's hearts
The judge put him in prison.	the judge clapped when he sang in jail	not_entailment	the judge clapped him in jail
They used their hands and feet to climb to the summit of the mountain.	the cats clawed their way to the top of the curtain	not_entailment	they clawed their way to the top of the mountain.
She grabbed the doorknob with her hand.	she clawed the door .	not_entailment	she clawed the doorknob.
The politician attacked his rival.	the politician clawed out his rival's eyes .	not_entailment	the politician clawed his rival.
Sales increased following the reduction in prices.	salespeople were climbing after ladders were lowered	not_entailment	sales were climbing after prices were lowered
The path ascended the entire length of the hill.	the puffin climbed all the way to the top of the hill	not_entailment	the path climbed all the way to the top of the hill
This young man knows how to advance in social status.	this young man knows how to climb the tall ladder	not_entailment	this young man knows how to climb the social ladder
Prices increased significantly.	vines climbed up the steep wall	not_entailment	prices climbed steeply
These operations are blocking the market.	the drain is being clogged by these operations	not_entailment	the market is being clogged by these operations
She was unable to think clearly due to her fear.	hair clogged her pipe	not_entailment	fear clogged her mind
My emotions influence my ability to make an impartial decision in this matter.	my personal crayons color my drawings in this case	not_entailment	my personal feelings color my judgment in this case
His political beliefs influence the content of his lectures.	his paints color his posters	not_entailment	his political ideas color his lectures
The rooms were connected.	the people in the room communicated	not_entailment	the rooms communicated
His dedication to his ill spouse resulted in a solitary life.	his murdering his sick wife condemned him to a lonely existence in prison	not_entailment	his devotion to his sick wife condemned him to a lonely existence
The fire destroyed the building.	the firefighter consumed the sandwich	not_entailment	the fire consumed the building
The comedian made the crowd laugh uncontrollably.	the comedian violently convulsed on the floor	not_entailment	the comedian convulsed the crowd
You can rely on me to provide assistance whenever you need it.	you can count my things any time	not_entailment	you can count on me to help you any time
The old cheese was covered in moving maggots.	the old cat was crawling toward the door	not_entailment	the old cheese was crawling with maggots
The speech concluded the meeting.	the queen crowned the prince	not_entailment	the speech crowned the meeting
A weather vane is positioned at the highest point of the building.	the king crowned the prince	not_entailment	a weather vane crowns the building
She felt very sad and disappointed when he declined her invitation.	she was crushed by a boulder	not_entailment	she was crushed by his refusal of her invitation
Seurat brought pointillism to its highest point of development.	the mountain culminated at its peak	not_entailment	seurat culminated pointillism.
The rejection made him feel as if he had been physically struck.	they dashed by the store	not_entailment	dashed by the refusal
He suddenly realised that she had been unfaithful to him.	the sun dawned on him	not_entailment	it dawned on him that she had betrayed him
The era of computers had begun.	the sun had dawned	not_entailment	the age of computers had dawned
The negative feedback on his work diminished his self-esteem.	the needle deflated his balloon	not_entailment	the bad review of his work deflated his self-confidence
The new measures caused the economy to shrink.	the new measures deflated the balloons	not_entailment	the new measures deflated the economy
The excess of oil caused gas prices to decrease.	the glut of oil depressed her	not_entailment	the glut of oil depressed gas prices
The absence of rain caused the water level in the reservoir to decrease.	the lack of rain had depressed the farmers	not_entailment	the lack of rain had depressed the water level in the reservoir
She created a convincing reason for not going to school that day.	she designed a good shed for the class that day .	not_entailment	she designed a good excuse for not attending classes that day.
A fire destroyed our home.	ferrets had devoured our hominy	not_entailment	fire had devoured our home
She read his novels with great enthusiasm and speed.	she devoured his nougat	not_entailment	she devoured his novels
I am unable to process all this information.	i cannot digest all this food	not_entailment	i cannot digest all this information
The government condensed the entire law into a code.	the government workers digested the entire cake	not_entailment	the government digested the entire law into a code
He drank three glasses of martini before dinner.	he downed three trees before dinner.	not_entailment	he downed three martinis before dinner.
Some people can eat a pound of meat in one meal.	some people can down a ton of missiles in the course of one mission.	not_entailment	some people can down a pound of meat in the course of one meal.
Stock prices are gradually increasing.	leaves are drifting higher on the wind	not_entailment	stock prices are drifting higher
My son travelled aimlessly around California for years before he enrolled in law school.	my son drifted holes as an engineer for years in california before going to law school	not_entailment	my son drifted around for years in california before going to law school
The stock market gradually increased in value.	the leaves drifted upward on the wind	not_entailment	the stock market drifted upward
The mother listens to every word her son says on stage.	the mother drinks in every drop of her juice on the stage	not_entailment	the mother drinks in every word of her son on the stage
I was overwhelmed with work.	i almost drowned in the lake	not_entailment	i was drowned in work
She drank alcohol to forget her problems.	she drowned her baby in the tub	not_entailment	she drowned her trouble in alcohol
As she got older, she became less interested in travelling.	time dulled her blades	not_entailment	middle age dulled her appetite for travel
The company fired him after many years of employment.	the company dumped their fax machine after many years of service	not_entailment	the company dumped him after many years of service
Some positive outcomes were discovered during the research.	some nice roses emerged from the soil	not_entailment	some nice results emerged from the study
The event was firmly embedded in her memory.	memory of the event was engraved into a plaque	not_entailment	the event engraved itself into her memory
The Turks killed the Armenians in 1915.	the turks erased the chalkboard in 1915	not_entailment	the turks erased the armenians in 1915
The boss became very angry when he was informed of the secretary's resignation.	the bomb exploded right when he heard of the resignation of the secretary	not_entailment	the boss exploded when he heard of the resignation of the secretary
The Middle East is experiencing political and social instability.	the alcohol is fermenting	not_entailment	the middle east is fermenting
The child felt proud.	fill the chalice with prune juice	not_entailment	fill the child with pride
Each star appeared to burn more brightly than before.	every disease seemed to flare up with new intensity	not_entailment	every star seemed to flare with new intensity.
The night sky suddenly became brighter due to the intense and large-scale attack.	the bomb flared during the massive bombardment.	not_entailment	the night sky flared with the massive bombardment.
The most recent information is transmitted to every command post.	the light is flashed to all command posts	not_entailment	the latest intelligence is flashed to all command posts
The father hit him with his hand.	the father flicked his hair with his hand.	not_entailment	the father flicked him with his hand.
The Republicans are suggesting a tax reform.	the republicans are floating the boat on the water	not_entailment	the republicans are floating the idea of a tax reform
The dancer moved gracefully across the stage.	the balloon floated across the stage	not_entailment	the dancer floated across the stage
The government allowed the ruble to fluctuate freely in the market for a few months.	the government floated the ship for a few months	not_entailment	the government floated the ruble for a few months
The crowd moved out of the stadium in a continuous stream.	the water flowed out of the stadium	not_entailment	the crowd flowed out of the stadium
The sky turned pink.	the face flushed with rosy splendor	not_entailment	the sky flushed with rosy splendor
Develop the young child's personality traits.	form the young child's clay	not_entailment	form the young child's character
The journalists were prevented from speaking freely.	the victim was gagged	not_entailment	the press was gagged
The moon's reflection on the lake's surface was visible.	the man glared back at the moon from the lake	not_entailment	the moon glared back at itself from the lake's surface
The sun shone brightly and intensely upon us.	the man glared down at us	not_entailment	the sun glared down on us
Her face was warm and red after she left the sauna.	her face glowed when she saw him in the sauna	not_entailment	her face glowed when she came out of the sauna
This story will capture your attention.	this crab will grab you	not_entailment	this story will grab you
The conversation gradually shifted to the topic of politics.	the planets gravitated towards the black hole	not_entailment	the conversation gravitated towards politics
He tried to think of a link.	his hand groped to find the switch	not_entailment	his mind groped to make the connection
The intense rainfall caused the soil to erode and form channels.	the heavy bowler guttered.	not_entailment	the heavy rain guttered the soil.
Make one's goals and abilities work together.	harmonize one's choir with one's pianist	not_entailment	harmonize one's goals with one's abilities
These rivers originate from a mountainous area in the Himalayas.	these ranchers head toward a mountain range in the himalayas	not_entailment	these rivers head from a mountain range in the himalayas
The wheat's heads appeared sooner than usual this year.	the wheat headed the list this year	not_entailment	the wheat headed early this year
He gave him a large amount of work.	he heaped praise on him	not_entailment	he heaped him with work
The oscillator searches for the correct frequency.	the ombudsman hunts for the correct rabbits	not_entailment	the oscillator hunts about the correct frequency
The rich people's showy lifestyle causes the poor to feel angry.	the ostentatious way the rich burn the woods ignites the houses of the poor	not_entailment	the ostentatious way of living of the rich ignites the hatred of the poor
The way they speak makes us think they are telling the truth.	their lasagna inclines us on the couch	not_entailment	their language inclines us to believe them
His laughter makes everyone in the same room laugh.	his virus infects everyone who is in the same room	not_entailment	his laughter infects everyone who is in the same room
The charges were exaggerated.	the mattresses were inflated	not_entailment	the charges were inflated
Increase the amount of money in circulation.	inflate the balloon	not_entailment	inflate the currency
He revitalized the performance.	he injected new drugs into the performer's system	not_entailment	he injected new life into the performance
She had to manage her job and her children simultaneously.	she had to juggle her balls and her bowling pins	not_entailment	she had to juggle her job and her children
The recoil of the gun pushed against my shoulder.	the mule kicked back into my shoulder.	not_entailment	the gun kicked back into my shoulder.
The businessman transferred millions of dollars from one account to another without sufficient funds to cover the transactions.	the businessman flew millions of kites	not_entailment	the businessman kited millions of dollars
This may result in you being imprisoned.	this plane may land on top of the jail	not_entailment	this may land you in jail
Create the initial structure for a new health care strategy.	lay the foundation for a new health care facility	not_entailment	lay the foundation for a new health care plan
Place a responsibility on someone.	lay a hand on someone	not_entailment	lay a responsibility on someone
Someone gave the information to the newspaper without authorisation.	the ink leaked onto the paper	not_entailment	the news were leaked to the paper
The information was revealed even though he tried to keep it hidden.	the water leaked out despite his secrecy	not_entailment	the news leaked out despite his secrecy
Westerns have a quality that evokes the ancient gladiators and is not limited by time.	Western Rome was gladiatorial.	not_entailment	‘ Westerns have a gladiatorial , timeless quality .
£45,000 was the requested amount and I was not surprised that the transaction was delayed.	£45,000 was the asking price and I was not surprised that the seller , so to speak , hung the painting .	not_entailment	£45,000 was the asking price and I was not surprised that the sale , so to speak , hung fire .
Primal Scream is not a name that would make you anticipate self-centred acoustic drawings.	Primal Scream Not a name which would lead you to expect self-absorbed doodlings on paper .	not_entailment	Primal Scream Not a name which would lead you to expect self-absorbed acoustic doodlings .
London's leading pair, feeling annoyed by this, made 30 September feel like the longest afternoon.	London 's leading pair , as if their interest were piqued by this , turned 30 September into the longest afternoon .	not_entailment	London 's leading pair , as if piqued by this , turned 30 September into the longest afternoon .
The person speaking on the other end of the line was clearly agitated, and it required a minute of focused attention to understand the information being conveyed.	The voice at the other end was plainly over-excited and it took him a minute to disentangle the ball of yarn he was given .	not_entailment	The voice at the other end was plainly over-excited and it took him a minute to disentangle what he was being told .
An insect landed on the vacant, unblinking helmet's transparent covering, and moved across the surface.	A fly landed on the empty vizor, staring at it , and then crawled across it .	not_entailment	A fly landed on the empty , staring vizor , and crawled across it .
The marks on the floor covering have remained after each alteration of the label.	The bugs on the carpet have survived every name change .	not_entailment	The stains on the carpet have survived every name change .
Paula leaned against the cutting table, attempting to appear relaxed and unconcerned.	Paula 's parrot perched herself on the cutting table trying to look nonchalant .	not_entailment	Paula perched herself against the cutting table trying to look nonchalant .
Find a 1980 Toyota Corolla or 1982 Nissan Sunny that has not been affected by rust, and you can purchase it with certainty.	Find the driver of a 1980 Toyota Corolla or 1982 Nissan Sunny that has not succumbed to disease , and you can buy with confidence .	not_entailment	Find a 1980 Toyota Corolla or 1982 Nissan Sunny that has not succumbed to rust , and you can buy with confidence .
A dog's loud, empty-sounding bark came from one of the stone sheds, but there was no visible activity near the buildings.	The hollow bone of a dog came from one of the stone sheds , but there was no sign of life around the buildings .	not_entailment	The hollow barking of a dog came from one of the stone sheds , but there was no sign of life around the buildings .
Recently, there has been an additional factor, which is partly exaggerated by the media and politicians, and partly a genuine issue: drugs.	Recently , of course , there has been an added dimension — inflated by politicians : balloons .	not_entailment	Recently , of course , there has been an added dimension — part media-and-politician inflated , part real : drugs .
Secondly, it would guarantee that employees benefited from legally protected entitlements and diminish the focus on union privileges.	Second , it would ensure that workers enjoyed positive rights under law and reduce the emphasis of disease immunities .	not_entailment	Second , it would ensure that workers enjoyed positive rights under law and reduce the emphasis of union immunities .
Completely depleted of energy.	Exhausted the resources .	not_entailment	Exhausted .
They convince their parents with a positive and optimistic view of the world, which makes their parents feel more confident and secure.	They win their parents over with a rose-tinted vase which is decidedly reassuring .	not_entailment	They win their parents over with a rose-tinted vision of the world which is decidedly reassuring .
No matter the location, the only differences are the accents and the clothing styles: in one place, the locals wear slacks, while in another, the locals wear blue jeans.	No matter ; only the accents change — and the pants : here , the good blue-jeans have squares .	not_entailment	No matter ; only the accents change — and the pants : here , the squares wear slacks , the good guys blue-jeans .
Other organizations could not be incorporated but could still be influenced by the Central Office.	Other liquids could not be absorbed but could still be brought within the Central Office orbit .	not_entailment	Other organizations could not be absorbed but could still be brought within the Central Office orbit .
Nor, if we are in a state of rationality, because we desire to experience the effects of alcohol intoxication.	Nor , if we are in civilised cast of characters , because we wish to become drunk .	not_entailment	Nor , if we are in civilised cast of mind , because we wish to become drunk .
Was it even now following them, moving without making any noise from one hiding place to another, like a tiger in the city?	Was he even now shadowing the painting , moving soundlessly from cover to cover , like a tiger in the steel jungle ?	not_entailment	Was it even now shadowing them , moving soundlessly from cover to cover , like a tiger in the steel jungle ?
Berry's songs are believable symbols of rock'n'roll rebellion or, at least, young people's pursuit of pleasure.	Berry made plausible emblems of rock'n'roll rebellion or , at any rate , youthful hedonism , on the jar .	not_entailment	Berry 's songs are plausible emblems of rock'n'roll rebellion or , at any rate , youthful hedonism .
The person appears to be fully alert and could have risen from their bed.	seems to be wide ; could not cross it	not_entailment	seems to be wide awake could of got up
Rocastle passed the ball to Thomas with a precise movement, allowing Thomas to run towards the goal, but Rhodes quickly left his position to block the shot.	A neat step-over by Rocastle sent Thomas hurtling in on goal but Rhodes moved sharply off his line to smother the fire .	not_entailment	A neat step-over by Rocastle sent Thomas hurtling in on goal but Rhodes moved sharply off his line to smother the shot .
I estimate that she survived for approximately two years following the stroke, according to Gordon.	Well I reckon twenty objects there.	not_entailment	Well I reckon she lived er a couple of years after the stroke Gordon .
Buzz said in a sharp tone that the amount of paperwork had increased after the trust assumed control.	‘ We 've had more paperwork , not less , since the trust took over , ’ and Buzz said it tasted tart .	not_entailment	‘ We 've had more paperwork , not less , since the trust took over , ’ Buzz said tartly .
You might have thought this was the police pretending and intimidating.	You might have assumed this was the police bluffing in poker .	not_entailment	You might have assumed this was the police bluffing and bullying .
I will help you so that you don't have to carry them.	I will save you from carrying them .	not_entailment	Save you , save you carrying them .
She went to sleep while listening to music coming from the room below.	She fell asleep to the smell of smoke drifting upwards from the drawing-room .	not_entailment	She fell asleep to the sound of music drifting upwards from the drawing-room .
You have to hope that the blankness will gradually disappear and allow life to enter.	You have to hope that its metals will slowly dissolve and let carbon in .	not_entailment	You have to hope that its blankness will slowly dissolve and let life in .
The removal of harmful substances is a difficult issue for developed nations.	That is one of the most intractable sheep in industrialised farms .	not_entailment	The disposal of toxic wastes is one of the most intractable problems facing industrialised societies .
Let those who are strict and negative about pleasure condemn, reject or ignore these desires; they are missing out.	Let puritans and pessimists damn , disapprove or dismiss these appetites for meat ; that is their loss .	not_entailment	Let puritans and pessimists damn , disapprove or dismiss these appetites ; that is their loss .
Avon walks carefully.	Avon treads on the grass warily .	not_entailment	Avon treads warily .
Although there were numerous and diverse bursts of action in the initial 40 minutes, Arsenal appeared to be relatively safe, even if they lacked creativity.	Despite many and varied flurries of snow in the first 40 minutes , Arsenal seemed reasonably secure if not inspired .	not_entailment	Despite many and varied flurries of activity in the first 40 minutes , Arsenal seemed reasonably secure if not inspired .
The house's red brick exterior was not illuminated by a yellow light.	No one bathed in the red brick house .	not_entailment	No golden light bathed the red brick of the house .
Does the 'serious physical injury' rule broaden the definition of murder excessively?	Does the ‘ grievous bodily harm ’ rule extend his arm too far ?	not_entailment	Does the ‘ grievous bodily harm ’ rule extend the definition of murder too far ?
Adam closed the front door and remained still for a moment, as if he was unable to move.	Adam closed the front door and stood there for a moment as if he could not find the wrench .	not_entailment	Adam closed the front door and stood there for a moment as if he could not wrench himself away .
The first attempt successfully contained the required elements.	This was conveniently encapsulated in the first bottle .	not_entailment	This was conveniently encapsulated in the first try .
But the act of presenting oneself in a certain way and engaging in make-believe extended to more than just the unions.	But ‘ posturing and pretending in front of a mirror ’ went far beyond the unions .	not_entailment	But ‘ posturing and pretending ’ went far beyond the unions .
Second, it would strengthen the perception and fundamental nature of the Intifada as a positive and beneficial influence, rather than a harmful one.	Second , it would consolidate the image and essence of the Intifada into one destructive force .	not_entailment	Second , it would consolidate the image and essence of the Intifada as a constructive , not a destructive , force .
The Spirit, bending towards the earth,	And the eagle , stooping earthward ,	not_entailment	And the Spirit ,  stooping  earthward ,
I drew a long, curved line for it.	Traced a winding lineage for it ,	not_entailment	Traced  a winding pathway for it ,
Then a cloud that is the color of snow began to expand.	Then a snow-white sheet unfolding ,	not_entailment	Then a snow-white cloud  unfolding  ,
It reached the highest point in the sky.	Till it touched the top of her head ,	not_entailment	Till it  touched  the top of heaven ,
Now you have discovered that we are the most powerful.	Now you find our strongest person ,	not_entailment	Now you  find  that we are strongest ,
Only adding fuel to the fire increased the intensity of the flames.	Only made the brighter burning fire ,	not_entailment	Only  made  the fire burn brighter ,
The hills were stroked gently.	Touched the rugged hills with his hand ,	not_entailment	Touched  the rugged hills with smoothness ,
His eyes were fixed on the train tracks.	On their tracks his hands were fastened ,	not_entailment	On their tracks his eyes were  fastened  ,
His heart beat rapidly.	And his butterfly within fluttered ,	not_entailment	And his heart within him  fluttered  ,
Hiawatha felt a profound sense of wonder.	Filled with water was Hiawatha 's jar	not_entailment	Filled  with awe was Hiawatha
Mudjekeewis experienced a state of happiness.	Filled with water was Mudjekeewis 's jar	not_entailment	Filled  with joy was Mudjekeewis
He witnessed a mental image of his younger self.	Saw the sea rise up before him	not_entailment	Saw his youth  rise  up before him
You remind me of past times.	You bring back the dearly departed ,	not_entailment	You bring back the days  departed  ,
You remind me of my passionate younger years.	You bring back my youth who are passionate ,	not_entailment	You  bring  back my youth of passion ,
In the past.	In the people long since departed ,	not_entailment	In the days long since  departed  ,
Provide the passionate and enthusiastic minds of young males with knowledge and information.	Fill the fiery barns of young men ?	not_entailment	Fill  the fiery brains of young men ?
After being touched, he felt more confident.	At his touch he felt new leather	not_entailment	At his touch he  felt  new courage
Until the night became dark.	Till they fell in the darkness ,	not_entailment	Till the darkness  fell  around them ,
The object forms when it comes into contact with the ground.	Taking earth when it touches the shape ,	not_entailment	Taking  shape when earth it touches ,
Until the night became dark.	Till they fell in the darkness ,	not_entailment	Till the darkness  fell  around them ,
Until the absence of light surrounds us.	Till we fall in the darkness ,	not_entailment	Till the darkness  falls  around us ,
He was afraid that he would become weak.	Fearing lest his son should fail him ,	not_entailment	Fearing lest his strength should  fail  him ,
The landscape rotated around him.	Round about him spun the spider 's web ,	not_entailment	Round about him  spun  the landscape ,
His powerful heart beat faster.	And his strong rabbit leaped within it ,	not_entailment	And his strong heart  leaped  within him ,
The red horizon glowed brightly.	Blazed and flared the red inferno ,	not_entailment	Blazed  and flared the red horizon ,
The red horizon was illuminated with a bright, fiery light.	Blazed and flared the red inferno ,	not_entailment	Blazed and  flared  the red horizon ,
And he informed the people.	And made corn for the people	not_entailment	And  made  known unto the people
The pathway extended in a straight line between the two.	Straight between them ran the person ,	not_entailment	Straight between them  ran  the pathway ,
Could not create a negative emotional state between them.	Could not breed two animals ,	not_entailment	Could not  breed  ill-will between them ,
They shared their thoughts and advice with each other.	For they kept each other 's necklaces ,	not_entailment	For they  kept  each other 's counsel ,
Now he excited their souls to an emotional state of intense desire.	Now he stirred their soup to boiling ,	not_entailment	Now he  stirred  their souls to passion ,
Now he made them feel pity.	Now he melted them together .	not_entailment	Now he  melted  them to pity .
All the people became more compassionate.	All the pillows of men were softened	not_entailment	All the hearts of men were  softened
His physical power is combined with moral excellence.	For his daughter allied to nobility .	not_entailment	For his strength  allied  to goodness .
Rose's response was not angry.	Rose , but made no one angry ,	not_entailment	Rose , but  made  no angry answer ;
Where a small stream guided them forward.	Where a women led them onward ,	not_entailment	Where a brooklet  led  them onward ,
They did not respond to the challenge.	For the challenge made no cake ,	not_entailment	To their challenge  made  no answer ,
The season of summer is approaching.	Grandma is coming for the summer ,	not_entailment	For the Summer-time is  coming  ,
A sound, an expression of terror, was heard.	Went a snake , a cry of horror ,	not_entailment	Went  a sound , a cry of horror ,
His thoughts were like tools that helped him navigate his mind.	For his thoughts as waiters served him ,	not_entailment	For his thoughts as paddles  served  him ,
His desires directed his actions.	And his waiters served him ,	not_entailment	And his wishes  served  to guide him ;
His desires provided him with direction.	And his waiters guided him ;	not_entailment	And his wishes served to  guide  him ;
The water reached the bones of the rib cage.	Till the waves washed away the rib-bones ,	not_entailment	Till the waves  washed  through the rib-bones ,
With their hot air exhalation.	With their fiery breath made charcoal	not_entailment	With their fiery breath  made  answer :
The moon, which was positioned horizontally, was visible to him.	Till the lion stared at him	not_entailment	Till the level moon  stared  at him
The blows he delivered were not harmful.	Harmless fell the trees he chopped down	not_entailment	Harmless  fell  the blows he dealt it
The war-club, which was heavy, fell without causing harm.	Harmless fell the heavy box	not_entailment	Harmless  fell  the heavy war-club ;
The mosses hung from the branches of the tree.	From whose branches trailed the jaguar ,	not_entailment	From whose branches  trailed  the mosses ,
The person who caused the high body temperature.	Him who sent the fiery arrows ,	not_entailment	Him , who  sent  the fiery fever ,
He ran faster than he could walk.	And he outran his opponents ;	not_entailment	And his heart  outran  his footsteps ;
And then she continued to speak, articulating each word carefully.	And then added the numbers slowly ,	not_entailment	And then  added  , speaking slowly ,
And he responded with a serious expression.	And made a vow very gravely :	not_entailment	And  made  answer very gravely :
Please, express your feelings, Minnehaha!	Let your friend speak , Minnehaha !	not_entailment	Let your heart  speak  , Minnehaha ! "
He slowed down his walking speed.	Though his watch he checked and slackened	not_entailment	Though his pace he  checked  and slackened
He slowed down his walking speed.	Though his rope he checked and slackened	not_entailment	Though his pace he checked and  slackened
That the time might go by more happily.	That the thought might pass more gayly ,	not_entailment	That the time might  pass  more gayly ,
That the time may move more happily.	That the thought may pass more gayly ,	not_entailment	That the time may  pass  more gayly ,
That the time may move more happily.	That the thought may pass more gayly ,	not_entailment	That the time may  pass  more gayly ,
As the springs emerge to receive the sunlight,	As the Springs to meet the neighbors ,	not_entailment	As the springs to  meet  the sunshine ,
When the clouds block the sunlight, causing areas of darkness to appear on the ground.	When the clouds drop rain on it !	not_entailment	When the clouds  drop  shadows on it !
Then my heart, which was previously in a state of distress, experiences a positive change and becomes more cheerful.	Then my troubled room is brightened ,	not_entailment	Then my troubled heart is  brightened  ,
Envious of the clapping hands directed at him,	Jealous of the apples they gave him ,	not_entailment	Jealous of the applause they  gave  him ,
If you would believe him.	Would you only give him gum ,	not_entailment	Would you only  give  him credence ,
That the time may go by more enjoyably.	That the thought may advance more gayly ,	not_entailment	That the time may  pass  more gayly ,
All the water turned red!	All the water flushed the crimson away !	not_entailment	All the water  flushed  with crimson !
They sensed the increase in intensity.	And they felt the flag rising , rising	not_entailment	And they  felt  it rising , rising ,
They experienced the sensation of something increasing in height.	And they felt the carpet rising , rising	not_entailment	And they felt it  rising  , rising ,
I was unable to observe your passionate feelings.	Could not see your passionfruit	not_entailment	Could not  see  your heart of passion ,
Of the days that were filled with happiness after the event.	Of the happy children that followed	not_entailment	Of the happy days that  followed  ,
The darkness enveloped the area, covering it like a piece of clothing.	Robed with wool as a garment	not_entailment	Robed  with darkness as a garment .
The tree branches moved up and down, making a sound like laughter.	Till the tree tops shook from wind	not_entailment	Till the tree-tops  shook  with laughter ,
When the quiet night arrived.	When the noiseless owl descended	not_entailment	When the noiseless night  descended
The darkness surrounded her.	Guskewau , the ribbon , wrapped her	not_entailment	Guskewau , the darkness ,  wrapped  her
The cornfields were filled with the sound of laughter.	Till the phones rang	not_entailment	Till the cornfields  rang  with laughter ,
The song that this shape made me think of.	And the song this child suggested	not_entailment	And the song this shape  suggested
I have influenced you in a way that is comparable to the effect of a magical incantation.	Such the net I cast upon you	not_entailment	Such the spell I  cast  upon you ,
The sound of silence filled the entire planet.	Covered all the earth with cement	not_entailment	Covered  all the earth with silence ,
The season of Spring arrived, and the entire forest	Came the sheep , and all the forest	not_entailment	Came  the Spring , and all the forest
The clouds are removed from the sky.	As the dirt is swept from the floor	not_entailment	As the clouds are  swept  from heaven ,
As the frozen water is removed from the rivers.	As the ice is swept from the floor	not_entailment	As the ice is  swept  from rivers ,
The sky was high above him.	Far above him swam the dolphins	not_entailment	Far above him  swam  the heavens ,
I will not be able to take revenge on him.	That my letter shall not reach him !	not_entailment	That my vengeance shall not  reach  him ! "
He responded cautiously.	With reserve he thus made pie	not_entailment	With reserve he thus  made  answer :
The object contracted.	Till it drew itself a portrait	not_entailment	Till it  drew  itself together ,
It changed its shape and appearance.	Till it took the form and signed it	not_entailment	Till it  took  the form and features
He hit the doorways with his war-club.	With his anger smote the kings	not_entailment	With his war-club  smote  the doorways ,
Kwasind felt sleepy.	Fell a doorknob on Kwasind	not_entailment	Fell  a drowsiness on Kwasind ;
The winter storm was very strong and loud.	Raged and roared the lion	not_entailment	Raged and  roared  the wintry tempest ,
Disasters do not occur in isolation.	So ducks come not singly	not_entailment	So disasters  come  not singly ;
Their facial expressions did not alter.	Not a plane came o'er their heads	not_entailment	Not a change  came  o'er their features ;
We have subjected you to a test.	We have put you in the bedroom	not_entailment	We have  put  you to the trial ,
The person collapsed and was unable to stand up due to physical frailty.	Fell and could not rise from the ground	not_entailment	Fell , and could not  rise  from weakness ,
She covered her face, but remained silent.	Hid her face, but made no shadow	not_entailment	Hid her face , but  made  no answer ;
When they looked at her,	At the stones they cast upon the lake	not_entailment	At the looks they  cast  upon her ,
Let us spend the night in each other's company.	Let us pass the test together	not_entailment	Let us  pass  the night together ,
All the fields are filled with flowers that move in the wind.	All the fans wave with blossoms	not_entailment	All the meadows  wave  with blossoms ,
As they were talking, the night came to an end.	While they spake , the bird departed	not_entailment	While they spake , the night  departed  :
The season of Spring arrived with its full beauty.	Came the peacock with all its splendor	not_entailment	Came  the Spring with all its splendor ,
The sun illuminated his face.	Fell the moonlight on his features	not_entailment	Fell  the sunshine on his features ,
The evening became darker and cooler.	Fell the evening 's cool acrobat	not_entailment	Fell  the evening 's dusk and coolness ,
He torments him and looks at him with eyes that express anger and unhappiness.	Torments him ; round he throws his dirty laundry	not_entailment	Torments him ; round he  throws  his baleful eyes
And the state of not being active can never exist, positive anticipation never arrives.	And rats can never dwell , hope never comes	not_entailment	And rest can never  dwell  , hope never comes
And inactivity can never be maintained, hope never arrives.	And rest can never dwell , she never comes	not_entailment	And rest can never dwell , hope never  comes
I started working on the issue immediately after waking up.	i attacked the one giving us problem as soon as i got out of bed	not_entailment	i attacked the problem as soon as i got out of bed
Which candidate are you supporting?	which horse are you riding on its back?	not_entailment	which horse are you backing?
She often spoke loudly into the microphone.	she tended to produce explosive sounds when speaking into a microphone	not_entailment	she tended to blast when speaking into a microphone
Do not eat your food too quickly!	don't bolt to your food!	not_entailment	don't bolt your food!
The judge put him in jail.	the judge clapped him into the jail 	not_entailment	the judge clapped him in jail
The politician attacked his rival.	the politician clawed the face of his rival.	not_entailment	the politician clawed his rival.
This young man knows how to increase his social status.	this young man knows how to climb a ladder	not_entailment	this young man knows how to climb the social ladder
She was unable to think clearly because of her fear.	fear clogged her heart	not_entailment	fear clogged her mind
She read his novels with great enthusiasm and speed.	she devoured his novels for some reason and choked	not_entailment	she devoured his novels
My son moved from place to place in California for several years before he enrolled in law school.	my son drifted around the lakes in california for years before going to law school	not_entailment	my son drifted around for years in california before going to law school
The mother listens attentively to every word her son says on stage.	the mother drinks because of every word of her son on the stage	not_entailment	the mother drinks in every word of her son on the stage
I was overwhelmed with a large amount of work.	i was drowned because of my work	not_entailment	i was drowned in work
She drank alcohol to forget her problems.	she was drowned because of her trouble in alcohol	not_entailment	she drowned her trouble in alcohol
The boss became very angry when he was informed of the secretary's resignation.	the boss bombed himself when he heard of the resignation of the secretary	not_entailment	the boss exploded when he heard of the resignation of the secretary
Each star appeared to burn more brightly than before.	every star seemed to flare with new clothes.	not_entailment	every star seemed to flare with new intensity.
The dancer moved gracefully across the stage.	the dancer floated across the stage with a cart	not_entailment	the dancer floated across the stage
The government allowed the ruble to fluctuate freely in the market for a few months.	the government floated the ruble in a pond for a few months	not_entailment	the government floated the ruble for a few months
He gave him a large amount of work.	he heaped him with documents from work	not_entailment	he heaped him with work
The businessman transferred millions of dollars illegally.	the businessman flew a kite made of millions of dollars	not_entailment	the businessman kited millions of dollars
We can physically support ourselves by resting on this man's body.	we can lean on this man's back	not_entailment	we can lean on this man
'No,' he said, then smiled at me in a patronising way.	‘ No , ’ he said helpfully , then bestowed a cake with a patronising smile to me .	not_entailment	‘ No , ’ he said helpfully , then bestowed a patronising smile on me .
He identifies the requirements of the business and provides the solution.	He finds out what the needs of the business are , and prescribes the cure for every patient.	not_entailment	He finds out what the needs of the business are , and prescribes the cure .
Ellen expressed that it would be more beneficial for the person in question to gain self-awareness.	‘ I think she 'd do better to understand herself , ’ Ellen said with a tart in her mouth.	not_entailment	‘ I think she 'd do better to understand herself , ’ Ellen said tartly .
'Oh, and there is one additional piece of information that I can confirm,' he stated with a negative tone.	Oh , and there 's one more thing you can be sure of , ’ he added with a sour smell in his mouth .	not_entailment	Oh , and there 's one more thing you can be sure of , ’ he added sourly .
We pressured them from the beginning and did not allow them to relax.	We gave them rattling sounds from the first minute and did n't give them any breathing space .	not_entailment	We rattled them from the first minute and did n't give them any breathing space .
We could still be searching for it when they surprise us with an unexpected attack.	We could still be looking for it when they bomb us out of the water . ’	not_entailment	We could still be looking for it when they blow us out of the water . ’
No one who was at the Brewery Field ( perhaps not even the selectors ) would give two pennies for their ability to do so .	No one who was at the Brewery Field ( perhaps not even the selectors ) would bet twopence for their ability to do so .	not_entailment	No one who was at the Brewery Field ( perhaps not even the selectors ) would give twopence for their ability to do so .
Four of the absentees felt the restless uneasiness of being part of the Welsh team.	Four of the absentees suffered the discomfort caused by the squirms of the Welsh squad .	not_entailment	Four of the absentees suffered the squirming discomfort of being among the Welsh squad .
There are few things more unpleasant than being forced to read a book you dislike.	There are few things worse than being bludgeoned with a book you hate .	not_entailment	There are few things worse than being bludgeoned into reading a book you hate .
